


4444444444444

111XXXXXXXXXX

5555555555555

XXXXXXXXXX111

7777777777777

666XXXXXXXXXX

3333333333333

XXXXXXXXXX333